# Frame-related keywords #

setFrameSize	KEYWORD2
getFrameSize	KEYWORD2
setID	KEYWORD2
createFrame	KEYWORD2
addSensor	KEYWORD2
showFrame	KEYWORD2
encryptFrame	KEYWORD2
decryptFrame	KEYWORD2
setFrameType	KEYWORD2
buffer	KEYWORD2
length	KEYWORD2
WaspFrame	KEYWORD2
setFrameSize	KEYWORD2
getFrameSize	KEYWORD2
createFrame	KEYWORD2
encryptFrame	KEYWORD2
setFrameType	KEYWORD2
setFrameType	KEYWORD2
addSensor	KEYWORD2
checkFields	KEYWORD2
setID	KEYWORD2
getID	KEYWORD2
addTimestamp	KEYWORD2
decrementSequence	KEYWORD2
frame	KEYWORD3

MAX_FRAME	LITERAL1
UNICAST_16B	LITERAL1
UNICAST_64B	LITERAL1
BROADCAST_MODE	LITERAL1
EXAMPLE_FRAME	LITERAL1
TIMEOUT_FRAME	LITERAL1
EVENT_FRAME	LITERAL1
ALARM_FRAME	LITERAL1
SERVICE1_FRAME	LITERAL1
SERVICE2_FRAME	LITERAL1
SET_TIME_FRAME	LITERAL1
AES128_ECB_FRAME	LITERAL1
AES192_ECB_FRAME	LITERAL1
AES256_ECB_FRAME	LITERAL1
TYPE_UINT8	LITERAL1
TYPE_INT	LITERAL1
TYPE_FLOAT 			LITERAL1
TYPE_CHAR	LITERAL1
TYPE_ULONG	LITERAL1
BINARY	LITERAL1
ASCII	LITERAL1
ENCRYPTED_FRAME	LITERAL1




#SENSOR CONSTANTS

SENSOR_CO	LITERAL1	Constants
SENSOR_CO2	LITERAL1	Constants
SENSOR_O2	LITERAL1	Constants
SENSOR_CH4	LITERAL1	Constants
SENSOR_LPG	LITERAL1	Constants
SENSOR_NH3	LITERAL1	Constants
SENSOR_AP1	LITERAL1	Constants
SENSOR_AP2	LITERAL1	Constants
SENSOR_SV	LITERAL1	Constants
SENSOR_NO2	LITERAL1	Constants
SENSOR_O3	LITERAL1	Constants
SENSOR_VOC	LITERAL1	Constants
SENSOR_TCA	LITERAL1	Constants
SENSOR_TFA	LITERAL1	Constants
SENSOR_HUMA	LITERAL1	Constants
SENSOR_PA	LITERAL1	Constants
SENSOR_PW	LITERAL1	Constants
SENSOR_BEND	LITERAL1	Constants
SENSOR_VBR	LITERAL1	Constants
SENSOR_HALL	LITERAL1	Constants
SENSOR_LP	LITERAL1	Constants
SENSOR_LL	LITERAL1	Constants
SENSOR_LUM	LITERAL1	Constants
SENSOR_PIR	LITERAL1	Constants
SENSOR_ST	LITERAL1	Constants	
SENSOR_MCP	LITERAL1	Constants
SENSOR_CDG	LITERAL1	Constants
SENSOR_CPG	LITERAL1	Constants
SENSOR_LD	LITERAL1	Constants
SENSOR_DUST	LITERAL1	Constants
SENSOR_US	LITERAL1	Constants	
SENSOR_MF	LITERAL1	Constants
SENSOR_PS	LITERAL1	Constants
SENSOR_TCB	LITERAL1	Constants
SENSOR_TFB	LITERAL1	Constants
SENSOR_HUMB	LITERAL1	Constants
SENSOR_SOILT	LITERAL1	Constants
SENSOR_SOIL	LITERAL1	Constants
SENSOR_LW	LITERAL1	Constants
SENSOR_PAR	LITERAL1	Constants
SENSOR_UV	LITERAL1	Constants
SENSOR_TD	LITERAL1	Constants	
SENSOR_SD	LITERAL1	Constants
SENSOR_FD	LITERAL1	Constants
SENSOR_ANE	LITERAL1	Constants
SENSOR_WV	LITERAL1	Constants
SENSOR_PLV	LITERAL1	Constants
SENSOR_RAD	LITERAL1	Constants
SENSOR_CU	LITERAL1	Constants
SENSOR_WF	LITERAL1	Constants
SENSOR_LC	LITERAL1	Constants
SENSOR_DF	LITERAL1	Constants
SENSOR_BAT	LITERAL1	Constants
SENSOR_GPS	LITERAL1	Constants
SENSOR_RSSI	LITERAL1	Constants
SENSOR_MAC	LITERAL1	Constants
SENSOR_NA	LITERAL1	Constants
SENSOR_NID	LITERAL1	Constants
SENSOR_DATE	LITERAL1	Constants
SENSOR_TIME	LITERAL1	Constants
SENSOR_GMT	LITERAL1	Constants
SENSOR_RAM	LITERAL1	Constants
SENSOR_IN_TEMP	LITERAL1	Constants
SENSOR_ACC	LITERAL1	Constants
SENSOR_MILLIS	LITERAL1	Constants
SENSOR_STR	LITERAL1	Constants
SENSOR_MBT	LITERAL1	Constants
SENSOR_MWIFI	LITERAL1	Constants
SENSOR_UID	LITERAL1	Constants
SENSOR_RB	LITERAL1	Constants
SENSOR_PH	LITERAL1	Constants
SENSOR_ORP	LITERAL1	Constants
SENSOR_DO	LITERAL1	Constants
SENSOR_COND	LITERAL1	Constants
SENSOR_WT	LITERAL1	Constants
SENSOR_DINA	LITERAL1	Constants
SENSOR_DICA	LITERAL1	Constants
SENSOR_DIF	LITERAL1	Constants
SENSOR_DICL	LITERAL1	Constants
SENSOR_DIBR	LITERAL1	Constants
SENSOR_DII	LITERAL1	Constants
SENSOR_DICU2	LITERAL1	Constants
SENSOR_DIK	LITERAL1	Constants
SENSOR_DIMG2	LITERAL1	Constants
SENSOR_DINO3	LITERAL1	Constants
SENSOR_DM_ST	LITERAL1	Constants
SENSOR_DM_SP	LITERAL1	Constants
SENSOR_TX_PWR	LITERAL1	Constants
SENSOR_LUX	LITERAL1	Constants
SENSOR_SPEED	LITERAL1	Constants
SENSOR_COURSE	LITERAL1	Constants
SENSOR_ALTITUDE	LITERAL1	Constants
SENSOR_HDOP	LITERAL1	Constants
SENSOR_VDOP	LITERAL1	Constants
SENSOR_PDOP	LITERAL1	Constants
SENSOR_FSM	LITERAL1	Constants
SENSOR_PLV1	LITERAL1	Constants
SENSOR_PLV2	LITERAL1	Constants
SENSOR_PLV3	LITERAL1	Constants
SENSOR_SOIL_C	LITERAL1	Constants
SENSOR_SOIL_D	LITERAL1	Constants
SENSOR_SOIL_E	LITERAL1	Constants
SENSOR_SOIL_F	LITERAL1	Constants
SENSOR_SOIL1	LITERAL1	Constants
SENSOR_SOIL2	LITERAL1	Constants
SENSOR_SOIL3	LITERAL1	Constants
SENSOR_TCC	LITERAL1	Constants
SENSOR_US_3V3	LITERAL1	Constants
SENSOR_US_5V	LITERAL1	Constants
SENSOR_LUM_D	LITERAL1	Constants
SENSOR_LUM_E	LITERAL1	Constants
SENSOR_LUM_F	LITERAL1	Constants
SENSOR_LP_D	LITERAL1	Constants
SENSOR_LP_E	LITERAL1	Constants
SENSOR_LP_F	LITERAL1	Constants
SENSOR_LL_D	LITERAL1	Constants
SENSOR_LL_E	LITERAL1	Constants
SENSOR_LL_F	LITERAL1	Constants
SENSOR_HALL_D	LITERAL1	Constants
SENSOR_HALL_E	LITERAL1	Constants
SENSOR_HALL_F	LITERAL1	Constants
SENSOR_WF_C	LITERAL1	Constants
SENSOR_WF_E	LITERAL1	Constants
SENSOR_TST	LITERAL1	Constants
SENSOR_TURB	LITERAL1	Constants
SENSOR_VAPI	LITERAL1	Constants
SENSOR_VPROG	LITERAL1	Constants
SENSOR_VBOOT	LITERAL1	Constants
SENSOR_GP_CL2	LITERAL1	Constants
SENSOR_GP_CO	LITERAL1	Constants
SENSOR_GP_ETO	LITERAL1	Constants
SENSOR_GP_H2	LITERAL1	Constants
SENSOR_GP_H2S	LITERAL1	Constants
SENSOR_GP_HCL	LITERAL1	Constants
SENSOR_GP_HCN	LITERAL1	Constants
SENSOR_GP_NH3	LITERAL1	Constants
SENSOR_GP_NO	LITERAL1	Constants
SENSOR_GP_NO2	LITERAL1	Constants
SENSOR_GP_O2	LITERAL1	Constants
SENSOR_GP_PH3	LITERAL1	Constants
SENSOR_GP_SO2	LITERAL1	Constants
SENSOR_GP_CH4	LITERAL1	Constants
SENSOR_GP_O3	LITERAL1	Constants
SENSOR_GP_CO2	LITERAL1	Constants
SENSOR_GP_TC	LITERAL1	Constants
SENSOR_GP_TF	LITERAL1	Constants
SENSOR_GP_HUM	LITERAL1	Constants
SENSOR_GP_PRES	LITERAL1	Constants
SENSOR_OPC_TC	LITERAL1	Constants
SENSOR_OPC_TF	LITERAL1	Constants
SENSOR_OPC_P	LITERAL1	Constants
SENSOR_OPC_PM1	LITERAL1	Constants
SENSOR_OPC_PM2_5	LITERAL1	Constants
SENSOR_OPC_PM10	LITERAL1	Constants
SENSOR_OPC_PART	LITERAL1	Constants
SENSOR_SWI_CA	LITERAL1	Constants
SENSOR_SWI_FL	LITERAL1	Constants
SENSOR_SWI_FB	LITERAL1	Constants
SENSOR_SWI_NO	LITERAL1	Constants
SENSOR_SWI_BR	LITERAL1	Constants
SENSOR_SWI_CL	LITERAL1	Constants
SENSOR_SWI_CU	LITERAL1	Constants
SENSOR_SWI_IO	LITERAL1	Constants
SENSOR_SWI_PB	LITERAL1	Constants
SENSOR_SWI_AG	LITERAL1	Constants
SENSOR_SWI_PH	LITERAL1	Constants
SENSOR_PH_A	LITERAL1	Constants
SENSOR_PH_B	LITERAL1	Constants
SENSOR_PH_C	LITERAL1	Constants
SENSOR_ORP_A	LITERAL1	Constants
SENSOR_ORP_B	LITERAL1	Constants
SENSOR_ORP_C	LITERAL1	Constants


